REB = "setup/countries/rebels.txt"
PIR = "setup/countries/pirates.txt"
BAR = "setup/countries/barbarians.txt"
MER = "setup/countries/mercenaries.txt"

# Greece/Macedonia
#CRT = "countries/crete.txt"

#IOR:
ABA = "setup/countries/caucasia/abasgia.txt"
ADC = "setup/countries/gaul/andecavia.txt"
AGD = "setup/countries/thule/agder.txt"
AKZ = "setup/countries/scythia/akatziri.txt"
ALN = "setup/countries/scythia/alans.txt"
ALT = "setup/countries/africa/altava.txt"
AMO = "setup/countries/gaul/armorica.txt"
ARG = "setup/countries/ireland/airgialla.txt"
AST = "setup/countries/iberia/asturica.txt"
ATC = "setup/countries/britain/alt clut.txt"
ATG = "setup/countries/iberia/astigi.txt"
ATZ = "setup/countries/scythia/altziagiri.txt"
AUT = "setup/countries/iberia/autrigoni.txt"
AWR = "setup/countries/africa/awras.txt"
BAS = "setup/countries/iberia/bastetania.txt"
BHM = "setup/countries/germania/boiahaemia.txt"
BIG = "setup/countries/gaul/bigerrones.txt"
BJS = "setup/countries/thule/bejsebakke.txt"
BKI = "setup/countries/germania/bucki.txt"
BLG = "setup/countries/britain/belgae.txt"
BUC = "setup/countries/germania/bucinobantes.txt"
BVI = "setup/countries/germania/boiavaria.txt"
BRA = "setup/countries/iberia/bracara.txt"
BRD = "setup/countries/germania/bardengau.txt"
BRG = "setup/countries/britain/brigantia.txt"
BRK = "setup/countries/thule/birka.txt"
BRS = "setup/countries/germania/brisigavi.txt"
BRY = "setup/countries/britain/bryneich.txt"
BSP = "setup/countries/scythia/bosporus.txt"
BUR = "setup/countries/gaul/burgundians.txt"
CAL = "setup/countries/caucasia/caucasian albania.txt"
CAS = "setup/countries/iberia/castulo.txt"
CAT = "setup/countries/britain/cat.txt"
CBG = "setup/countries/iberia/caesarobriga.txt"
CCD = "setup/countries/ireland/corcu duibhne.txt"
CCL = "setup/countries/ireland/corcu loigde.txt"
CCN = "setup/countries/britain/circenn.txt"
CEP = "setup/countries/britain/ce.txt"
CHA = "setup/countries/gaul/chamavia.txt"
CLG = "setup/countries/iberia/calagurris.txt"
CLN = "setup/countries/gaul/colonia.txt"
CMH = "setup/countries/ireland/conmhaicne.txt"
CNC = "setup/countries/ireland/cenel coirpri.txt"
CNT = "setup/countries/iberia/cantabri.txt"
CPS = "setup/countries/africa/capsa.txt"
CRD = "setup/countries/iberia/corduba.txt"
CRG = "setup/countries/ireland/ciarraige.txt"
CRL = "setup/countries/britain/corieltauvia.txt"
CRN = "setup/countries/britain/cornovia.txt"
CRW = "setup/countries/britain/caerwent.txt"
CST = "setup/countries/iberia/castulo.txt"
CTD = "setup/countries/gaul/castrodunum.txt"
CTV = "setup/countries/britain/catuvellaunia.txt"
CLU = "setup/countries/iberia/clunia.txt"
CON = "setup/countries/iberia/conimbriga.txt"
DAL = "setup/countries/illyria_dacia/dalmatia.txt"
DBN = "setup/countries/britain/dobunnia.txt"
DEI = "setup/countries/britain/deira.txt"
DFD = "setup/countries/britain/dyfed.txt"
DJB = "setup/countries/thule/dejbjerg.txt"
DLC = "setup/countries/ireland/dal cormaic.txt"
DLR = "setup/countries/ireland/dal riata.txt"
DRG = "setup/countries/germania/dragini.txt"
DRM = "setup/countries/thule/darum.txt"
DSB = "setup/countries/illyria_dacia/danubian suebi.txt"
DSM = "setup/countries/ireland/deisi muman.txt"
DUM = "setup/countries/gaul/dumnonia.txt"
DYF = "setup/countries/britain/dyfneint.txt"
EAN = "setup/countries/britain/eastanglia.txt"
EBR = "setup/countries/britain/ebrauc.txt"
EHE = "setup/countries/scythia/eastern hunnic empire.txt"
ELM = "setup/countries/britain/elmet.txt"
EME = "setup/countries/iberia/emerita.txt"
EOG = "setup/countries/ireland/eoganachta.txt"
EOW = "setup/countries/thule/eowland.txt"
ERE = "setup/countries/greece/eastern roman empire.txt"
ERN = "setup/countries/iran/eran.txt"
FIA = "setup/countries/thule/fiaera.txt"
FNV = "setup/countries/thule/finnveden.txt"
FRT = "setup/countries/britain/fortriu.txt"
FRY = "setup/countries/germania/fryslan.txt"
GAL = "setup/countries/gaul/gallia.txt"
GDD = "setup/countries/britain/gododdin.txt"
GDE = "setup/countries/britain/goddeu.txt"
GDM = "setup/countries/thule/gudme.txt"
GDS = "setup/countries/iberia/gades.txt"
GLH = "setup/countries/thule/gallehus.txt"
GLN = "setup/countries/sclavenia/galindia.txt"
GOT = "setup/countries/thule/gotaland.txt"
GPD = "setup/countries/illyria_dacia/gepids.txt"
GRN = "setup/countries/thule/grenland.txt"
GUT = "setup/countries/thule/gutaland.txt"
GWY = "setup/countries/britain/gwynedd.txt"
HAL = "setup/countries/thule/halland.txt"
HDB = "setup/countries/thule/hedeby.txt"
HDN = "setup/countries/africa/hodna.txt"
HER = "setup/countries/germania/herules.txt"
HES = "setup/countries/germania/hessim.txt"
HLU = "setup/countries/germania/hluini.txt"
HPL = "setup/countries/iberia/hispalis.txt"
HST = "setup/countries/germania/hastfala.txt"
IAZ = "setup/countries/illyria_dacia/iazyges.txt"
ICN = "setup/countries/britain/icenia.txt"
ILL = "setup/countries/iberia/illiberis.txt"
IRD = "setup/countries/ireland/irrus domnann.txt"
IRN = "setup/countries/iberia/iruna.txt"
JLG = "setup/countries/thule/jelling.txt"
KLB = "setup/countries/sclavenia/kolobrzeg.txt"
KNT = "setup/countries/britain/kent.txt"
KPG = "setup/countries/thule/kaupang.txt"
KRT = "setup/countries/caucasia/kartli.txt"
LAI = "setup/countries/ireland/laighin.txt"
LAP = "setup/countries/gaul/lapurdum.txt"
LAZ = "setup/countries/caucasia/lazica.txt"
LEN = "setup/countries/germania/lentienses.txt"
LGD = "setup/countries/gaul/lugdunensis.txt"
LJR = "setup/countries/thule/lejre.txt"
LND = "setup/countries/britain/lindum.txt"
LUP = "setup/countries/caucasia/lupenia.txt"
LMB = "setup/countries/germania/lombards.txt"
LSC = "setup/countries/scythia/lesser scythia.txt"
LUC = "setup/countries/iberia/lucus.txt"
LUT = "setup/countries/gaul/lutetia.txt"
MDE = "setup/countries/ireland/mide.txt"
MNA = "setup/countries/britain/manau.txt"
MOG = "setup/countries/gaul/mogontiacum.txt"
MRT = "setup/countries/ireland/mairtine.txt"
MSC = "setup/countries/ireland/muscraighe.txt"
MZG = "setup/countries/scythia/mazguts.txt"
NMN = "setup/countries/africa/nemencha.txt"
ODR = "setup/countries/sclavenia/oder.txt"
OEA = "setup/countries/africa/oea.txt"
OGD = "setup/countries/illyria_dacia/vidimiringia.txt"
OGT = "setup/countries/illyria_dacia/thiudimeringia.txt"
OGV = "setup/countries/illyria_dacia/valamiringia.txt"
ONO = "setup/countries/scythia/onoghurs.txt"
OSC = "setup/countries/iberia/osca.txt"
OSS = "setup/countries/iberia/ossonoba.txt"
OUA = "setup/countries/africa/ouarsenis.txt"
PAL = "setup/countries/iberia/pallantia.txt"
PAX = "setup/countries/iberia/pax iulia.txt"
POW = "setup/countries/britain/powys.txt"
RAN = "setup/countries/thule/ranrike.txt"
RBE = "setup/countries/thule/ribe.txt"
RGL = "setup/countries/thule/rogaland.txt"
RHE = "setup/countries/britain/rheged.txt"
RMR = "setup/countries/thule/romerike.txt"
ROM = "setup/countries/italia/rome.txt"
RPR = "setup/countries/gaul/ripuaria.txt"
RTM = "setup/countries/gaul/rotomagus.txt"
RTV = "setup/countries/germania/raetovarii.txt"
RUG = "setup/countries/germania/rugii.txt"
SAL = "setup/countries/gaul/salia.txt"
SAR = "setup/countries/scythia/saraghurs.txt"
SAV = "setup/countries/illyria_dacia/savia.txt"
SBR = "setup/countries/scythia/sabirs.txt"
SCL = "setup/countries/iberia/scallabis.txt"
SCN = "setup/countries/thule/scania.txt"
SCR = "setup/countries/illyria_dacia/scirii.txt"
SCT = "setup/countries/britain/scotia.txt"
SDG = "setup/countries/illyria_dacia/sadagares.txt"
SEG = "setup/countries/iberia/segobriga.txt"
SEN = "setup/countries/gaul/senonia.txt"
SIE = "setup/countries/germania/sievern.txt"
SLA = "setup/countries/africa/sala.txt"
SLM = "setup/countries/iberia/salamantica.txt"
SMB = "setup/countries/sclavenia/sambia.txt"
SMG = "setup/countries/sclavenia/semigallia.txt"
SSX = "setup/countries/britain/south saxons.txt"
STM = "setup/countries/thule/sorte muld.txt"
STR = "setup/countries/germania/stormarn.txt"
SUD = "setup/countries/sclavenia/sudovia.txt"
SVR = "setup/countries/illyria_dacia/savaria.txt"
TEG = "setup/countries/britain/tegeingl.txt"
TFG = "setup/countries/thule/toftegard.txt"
TFT = "setup/countries/germania/tofting.txt"
THL = "setup/countries/africa/thala.txt"
THU = "setup/countries/germania/thuringia.txt"
TIR = "setup/countries/ireland/tir chonaill.txt"
TNG = "setup/countries/gaul/tungria.txt"
TOL = "setup/countries/iberia/toletum.txt"
TRA = "setup/countries/gaul/traiectum.txt"
TRC = "setup/countries/illyria_dacia/torcilingi.txt"
TRG = "setup/countries/ireland/tir eoghain.txt"
TRN = "setup/countries/gaul/turonensis.txt"
TRV = "setup/countries/gaul/treverorum.txt"
TSO = "setup/countries/thule/tisso.txt"
TTH = "setup/countries/ireland/tethbae.txt"
UIB = "setup/countries/ireland/ui briuin.txt"
UIG = "setup/countries/ireland/ui garrchon.txt"
UIM = "setup/countries/ireland/ui maine.txt"
ULD = "setup/countries/ireland/ulaidh.txt"
UPP = "setup/countries/thule/uppsala.txt"
VAA = "setup/countries/thule/va.txt"
VAN = "setup/countries/africa/vandals.txt"
VDV = "setup/countries/sclavenia/vidivarii.txt"
VEL = "setup/countries/iberia/veleia.txt"
VIS = "setup/countries/gaul/visigoths.txt"
VLB = "setup/countries/africa/volubilis.txt"
VND = "setup/countries/illyria_dacia/vindobona.txt"
VST = "setup/countries/thule/vastra vang.txt"
WAL = "setup/countries/gaul/walhaland.txt"
WHE = "setup/countries/scythia/western hunnic empire.txt"
WHM = "setup/countries/germania/wihmuodi.txt"
WLG = "setup/countries/gaul/walhgau.txt"
WRE = "setup/countries/italia/western roman empire.txt"
WRN = "setup/countries/germania/warni.txt"
WSG = "setup/countries/germania/waissagawi.txt"
WST = "setup/countries/thule/westergo.txt"
